00 00 00 00 00 00 00 00 00 00 00 00 00 00 00 00 00 00 00 00 00 00 00 00 00 00 00
00 14 14 14 14 14 14 00 00 00 14 14 14 14 14 14 14 00 00 00 14 14 14 14 14 14 00
00 14 00 00 00 00 14 00 00 00 14 00 00 00 00 00 14 00 00 00 14 00 00 00 00 14 00
00 14 00 00 00 00 14 00 00 00 14 00 00 00 00 00 14 00 00 00 14 00 00 00 00 14 00
00 14 14 14 14 14 15 00 00 00 14 00 00 00 00 00 14 00 00 00 15 14 14 14 14 14 00
00 14 00 00 00 00 14 14 14 14 14 00 00 00 00 00 14 14 14 14 14 00 00 00 00 14 00
00 14 00 00 00 00 00 14 00 00 00 00 00 00 00 00 00 00 00 14 00 00 00 00 00 14 00
00 14 00 00 00 00 00 14 00 00 00 00 00 00 00 00 00 00 00 14 00 00 00 00 00 14 00
00 14 14 14 14 14 14 14 14 14 14 14 14 14 14 14 14 14 14 14 14 14 14 14 14 14 00
00 14 00 00 14 00 00 14 00 00 00 00 00 01 00 00 00 00 00 14 00 00 14 00 00 14 00
00 14 00 00 14 00 00 14 00 00 00 00 00 18 00 00 00 00 00 14 00 00 14 00 00 14 00
00 14 00 00 14 00 00 14 00 00 01 16 16 01 17 17 01 00 00 14 00 00 14 00 00 14 00
00 14 00 00 14 00 00 14 00 00 01 01 01 01 01 01 01 00 00 14 00 00 14 00 00 14 00
14 14 14 14 14 14 14 14 00 00 01 01 01 01 01 01 01 00 00 14 14 14 14 14 14 14 14
00 14 00 00 00 00 00 14 00 00 01 01 01 01 01 01 01 00 00 14 00 00 00 00 00 14 00
00 14 00 00 00 00 00 14 00 00 00 00 00 00 00 00 00 00 00 14 00 00 00 00 00 14 00
00 14 00 00 00 00 00 14 00 00 00 00 00 00 00 00 00 00 00 14 00 00 00 00 00 14 00
00 14 14 14 14 14 14 14 00 00 00 00 00 00 00 00 00 00 00 14 14 14 14 14 14 14 00
00 00 00 14 00 00 00 14 14 14 14 14 14 14 14 14 14 14 14 14 00 00 00 14 00 00 00
00 00 00 14 00 00 00 14 00 00 00 14 00 00 00 14 00 00 00 14 00 00 00 14 00 00 00
00 00 00 14 00 00 00 14 00 00 00 14 00 00 00 14 00 00 00 14 00 00 00 14 00 00 00
00 00 00 14 14 14 14 14 00 00 00 14 00 00 00 14 00 00 00 14 14 14 14 14 00 00 00
14 14 14 14 00 00 00 00 00 00 00 14 00 00 00 14 00 00 00 00 00 00 00 14 14 14 14
00 00 00 15 00 00 00 00 00 00 00 14 14 14 14 14 00 00 00 00 00 00 00 15 00 00 00
00 00 00 14 00 00 00 00 00 00 00 14 00 00 00 14 00 00 00 00 00 00 00 14 00 00 00
00 00 00 14 14 14 14 14 14 14 14 14 00 00 00 14 14 14 14 14 14 14 14 14 00 00 00
00 00 00 00 00 00 00 00 00 00 00 00 00 00 00 00 00 00 00 00 00 00 00 00 00 00 00